new	dvv	25325!_seg dgdgsdg
my site	My login	My password
fref	wfwef	24324
sefse	fjf	36463
rg	ui;h	ui;
ygk	hui;	ui;
rserh	lu	bh
rhdxh	bj;	b;
srgsg	seh	she
xth	vl	v
ckgh	bhu;	ijn
rj	vyl	vhl
tyk	 cftxc	ck
ctj	gu;	yu;
vg	ih	ji
tfl	ui	jo
tckk	gu;	ui
ftyk;	j	nio
hhjxjxtjtj	j	j
esrh	ylgu	vyl
hhx	bu	n
ehseh	gyu;	bu;
rtxrtj	vyu;	bu
dtjj	hi	jo
ytkftyk	ui'	iinio
6drrti	gmg	gu
ggyk	h	ni
s5usrdt	vu	hi
rhth	fyu	yu
hrj	vyu	io
rtjf	ul	jbui
fdn	yu	n
4ye	aye	syer
gerh	serhsh	serhs
egerg	serg	es
erer	segsg	seg
уауа	ыуа	аы
eg	hrdh	dhr
wagjku	xfgjhk	zsdxfcgh
[opikgftr	lkjhg	;lknjh
rm,jlhkgjfh	fyjdthfj	hgfjjh